Childhood sweetheart: ['i got married to my highschool friend.']
Parachuting: ['i would like to try sky diving.', 'before i die , i want to skydive.']
Polyamory: ['i wish my boyfriend did not want an open relationship.']
Nail art: ['i get my nails done every saturday.']
Algeria: ['my family is from algeria.']
Trophy: ['i have a lot of trophies from my childhood.']
Nicholas Sparks: ['my favorite writer is nicholas sparks.']
List of poisonous flowers: ['i work in a flower shop.']
Food truck: ['i think food trucks are awesome.']
Foster care: ['i am an orphan who was in the foster care system.']
Onion: ['my favorite food is raw onion.']
Peet's Coffee: ['i work in a coffee shop.']
J. Kenji López-Alt: ['i am a foodie.']
Goodwill Industries: ['i like to shop at goodwill.']
Tap dance: ['i have won tap dance competitions.']
Inline skating: ['i like rollerblading.']
Thursday: ['i go to the pool every thursday for three hours.']
Book discussion club: ['i attend book club every week.']
Horse racing: ['i am a professional horse racing handicapper.']
Pug: ['i own a pug , and he is the most loyal pet you will ever have.', 'i have a pug named corky.']
Green bean: ['i likw to go to the farmers markets to buy local veggies and fruits.']
Boca Raton, Florida: ['my parents recently moved to florida.']
Kobe beef: ['i love beef.']
Law school: ['i went to law school.']
Role-playing game: ['i love role play.']
Alien invasion: ['i enjoy movies about aliens invading the earth.']
Bachelor of Science in Nursing: ['i go to work early in the morning as a nurse.', 'i graduated with a nursing degree.']
Philip Larkin: ['i love to read fantasy novels and poetry.']
Tool (band): ['my favorite band is tool.']
Vitamin C: ['i take vitamin c when i have a cold.']
Diet (nutrition): ['i am on a diet.']
Drake: ['i cannot get enough of rap music , its so good.']
Michael Schoeffling: ['my favorite movie is 16 candles.']
Hamburger: ['my favorite food is a burger.', 'i love hamburgers.', 'my favorite food is hamburgers.']
Bengal cat: ['i had two cats growing up.']
Rick and Morty: ['my favorite tv show is rick and morty.']
Skin care: ['i take great care of my skin.']
Volcanology of Canada: ['i like hiking up volcanoes.']
Skittles (sport): ['i am a professional skittles player.']
Brown hair: ['i have brown hair.']
True crime: ['i love to read true crime books.']
Red hair: ['i have red hair.', 'i am a redhead.']
Black Forest gateau: ['my grandsons favorite type of cake is chocolate.']
Quake (video game): ['playing quake on slackware linux makes me happy.']
McDonald's: ['i currently work at mcdonald.', 'i love eating at mcdonalds.', 'my favorite food is a burger.', 'i work at mcdonalds.', 'i work at mcdonald s.', 'my favorite french fries are from mcdonalds.', 'i like chicken nuggets.', 'i got hired last week at mcdonald.', 'my guilty pleasure is mcdonald.', 'my guilty pleasure is mcdonald s.', 'i eat more junk food than i really should.']
On-again, off-again relationship: ['i do not think my girlfriend understands.']
Military: ['i am a veteran.']
Shades of green#Hunter green: ['my favorite color is hunter green.']
Victorian era: ['i like victorian things.']
Vikings: ['my brother thinks he is a viking.', 'i am a viking.']
Military rank: ['my husband is a soldier in the us army.']
E-book: ['i read ebooks more than hardcopies.']
Author: ['i want to become an author.']
Dairy farming: ['my family owns a dairy farm.']
Dentist: ['i am studying to be a dentist.', 'my mother is a dentist.', 'my dad is a dentist and my mom is a teacher.']
Cheese: ['i hate the taste of cheese.', 'my favorite food is cheese.']
Tourism in Rome: ['i want to visit rome , but i can t make myself go alone.']
Headphones: ['i prefer headsets over earbuds.']
Democratic Party (United States): ['i am a democrat.']
Fiscal conservatism: ['i believe the rich shouldn t be taxed as much.']
Travel: ['i travel a lot.', 'i have been all over the world.', 'i enjoy travel.']
Environmental engineering: ['i am an environmental engineer.']
University of Chicago: ['i went to college in chicago.']
Internet: ['i like the internet.']
Marvel Comics: ['i collect comic books.']
Alpine skiing: ['i was a champion downhill skier in college.']
Jim Carrey: ['i once wrote a biography of my favorite actor.']
Migraine: ['i had to call 911 when i had a terrible headache.']
Harley-Davidson: ['i ride a motorcycle , but it s not a harley.']
Titanic (1997 film): ['my favorite movie is titanic.']
Pub: ['i love to socialize.']
Cod: ['i am a fisherman.']
Teenage pregnancy: ['i am a college student who is a full time working mom.']
Punk rock: ['in the evenings i watch the door at a club where they play punkrock.']
Penguin Random House: ['i working in a publishing building.']
Parisian café: ['i daydream about cafes in paris.']
Cookie: ['i like cookies.']
Snapple: ['i love iced tea.']
Child care: ['i work at a daycare.']
Osteopathic medicine in the United States: ['my mom is an osteopath.']
Waterfowl hunting: ['my favorite season is duck hunting season.']
Self-confidence: ['i struggle with maintaining eye contact.']
Appalachian Trail: ['the appalachian trail is my favorite.']
Fish trap: ['i enjoy fishing.']
World War II: ['my grandpa was in wwii.']
Armadillo: ['i love animals.']
Cannibal Corpse: ['i listen to death metal.']
Autism: ['i was diagnosed with autism.', 'one child has autism.']
Indie rock: ['i like early 2000s indie music.', 'i am the lead singer for an indie band.']
Anthony Michael Hall: ['my favorite movie is 16 candles.']
Visual acuity: ['i have amazing eye sight.']
The Chronicles of Thomas Covenant: ['i love to read fantasy novels and poetry.']
Sixteen Candles: ['my favorite movie is 16 candles.']
Kiss: ['i have never kissed a woman.']
Drama school: ['i dream of becoming a famous actress.']
Driver's education: ['i cannot drive.']
List of chicken dishes: ['i am a carnivore.']
Geocaching: ['i geocache in my spare time.']
Bacon: ['i eat eggs and bacon for breakfast.']
Ford Motor Company: ['i drive a ford truck.']
Motivation: ['i have trouble getting motivated.']
Space: ['i wonder about what life in space would be like.']
Sears: ['i want to be a journalist but instead i sell washers at sears.']
Forensic Files: ['my favorite tv shows are forensic files and jeopardy.']
Toto (Oz): ['my dogs name is toto.']
Face Off (TV series): ['one of my favorite shows is face off on say.', 'one of my favorite shows is face off on syfy.']
Sephora: ['i like makeup.']
Aquarium: ['i build aquariums for a living.']
Dropping out: ['i dropped out of college.']
Agriculture: ['i live in a rural area.', 'i am a farmer.', 'i like to live off of the land.']
Parenting: ['i am a mother of two.', 'i have 5 kids.', 'i have twelve kids.', 'my dad is very strict with his kids.', 'i have a 7 year old daughter.', 'i am a mother of three.', 'i have 3 children.', 'i have 5 children.']
Rise Against: ['my favorite band is rise against.']
Pearl Jam: ['my favorite band is pearl jam.']
Joke: ['i tell bad jokes on purpose.']
San francisco: ['i am from san fransisco.']
Toyota: ['i drive only toyota.', 'i like toyota cars.']
London Marathon: ['i like running in marathons.']
American literature: ['my major was american literature and education.']
Sculpture: ['i am an artist and create with my mind and my hands.']
Valedictorian: ['i graduated valedictorian of my high school class.']
Color blindness: ['i am colour blind.', 'i am colorblind.']
Swing (dance): ['i love to dance.']
Grey's Anatomy: ['i love watching grey s anatomy.', 'i love watching greys anatomy.']
Crochet: ['i love to crochet.', 'i enjoy crosswords , crocheting , and football.', 'i like crocheting.']
Egyptian pyramids: ['i would love to visit the pyramids.']
Baker: ['i am a humble baker.']
Boy Scouts: ['i volunteer in my sons boy scout troop.']
Sex change: ['i wonder what it would be like to be a different gender.']
Graphic design: ['i am a graphic designer.']
Honda Civic: ['i drive a blue honda civic.', 'i drive a honda civic.']
Popcorn: ['i hate popcorn.']
The Beatles: ['i like the beatles.', 'i love the beatles.', 'my favorite band is the beatles.', 'favorite band is the beetles.']
Marketing: ['i work in sales.', 'i am recent college graduate looking for a job in marketing.']
Ultra Music Festival: ['i love going to concerts and dancing hard.']
Online shopping: ['i shop online , too much.']
Great white shark: ['i love sharks.']
Tupac Shakur: ['my favorite artist is 2pac.']
List of national parks of the United States: ['i like to visit national parks.']
Prince (musician): ['my favorite artist was prince.']
Ballroom dance: ['i love to dance.']
Arthritis: ['i am an old woman.']
Podcast: ['i listen to podcasts.']
Duramax V8 engine: ['my favorite truck is a chevy duramax.']
Top Chef: ['i auditionated in a cooking show.']
Friends: ['my favorite tv show is friends.']
Tiger: ['i wish i was a tiger.']
Snowboarding: ['i like to snowboard.', 'i like snowboarding.']
The Little Mermaid (1989 film): ['ariel is my favorite princess.', 'i believe that mermaids are real.']
Recreational fishing: ['i enjoy fishing.']
Archaeology: ['my brother is an archaeologist.']
Cheetos: ['i like to eat cheetos.']
Chocolate cake: ['i really like cake and don t prefer vegetables.', 'my grandsons favorite type of cake is chocolate.', 'my grandson s favorite type of cake is chocolate.', 'i like to make cakes.']
Lager: ['i always have a beer after work.']
The Improv: ['i had a gig at local theater last night.']
Chicago Housing Authority: ['i grew up in the projects of chicago.']
Britney Spears: ['my favorite singer is britney spears.']
Jimmy Fallon: ['i watch jimmy fallon s show every night.', 'i watch jimmy allons show every night.', 'i ran into jimmy fallon just the other day.']
Justin Bieber: ['my favorite singer is justin bieber.', 'i often think about quitting my job and becoming a roadie for justin bieber.']
Programming: ['i work remotely as a programmer.']
Children's literature: ['i write children s books.', 'i write childrens books.']
Orphanage: ['i grew up as an orphan.']
Backstreet Boys: ['i like the music group the backstreet boys.']
Single parent: ['my mother was a single mother.']
Stephen King: ['my favorite author is stephen king.']
Renaissance fair: ['i have been to a few renaissance fairs.']
Neil deGrasse Tyson: ['i have a poster of neil tyson degrasse on my wall.']
Independent music: ['i like early 2000s indie music.']
Isaiah Rashad: ['my favorite music artist is isaiah rashad.']
Eggplant: ['i love to eat eggplant.']
Fishing: ['i enjoy fishing.']
Truck driver: ['my father was a driver himself.']
Immigration to the United States: ['my mother is an immigrant from saudi arabia.', 'i was born outside the us.']
Canada: ['every fall i visit my sister in canada.', 'i like going to canada.', 'i spend the weekends travelling up to canada to relax and enjoy the view.']
Ford F-Series: ['i also like ford trucks.', 'i have a ford f150.', 'i own a ford truck.']
Coca-Cola: ['my favorite drink is coke.']
Argentina: ['i am argentinian.']
Lake Tahoe  i like dogs.: ['i grew up in nevada.']
Party City: ['i work at a local party store.']
Death metal: ['i listen to death metal.']
Royal Caribbean International: ['i am going on a cruise next month.']
Insurance: ['i work at an insurance firm.']
Roofer: ['i am a roofer.']
Lesbian: ['i am a lesbian.']
Drinking culture: ['i like to drink.']
Violin technique: ['i play the violin.']
Amateur geology: ['my hobbies include rock collecting and making macaroni art.']
Public affairs industry: ['i work as a public affairs liaison.']
Moustache: ['i have a pencil thin mustache.']
National Football League: ['i have an older brother who plays football in the nfl.']
Fantasy football (American): ['i play in a nfl fantasy football league.']
Cooking: ['i like to cook.', 'i love to cook for my family and friends.', 'i love to cook.']
Alfred Hitchcock: ['i enjoy watching mystery movies.']
Foreclosure: ['last month the farm was foreclosed so i m looking for a new job.']
Walmart: ['i work at walmart as a stocker.', 'i like to do all my shopping at walmart.']
Poaching: ['i like to hunt.']
Novel: ['i read three books a week.', 'i read tons of books.', 'i prefer reading to sports.', 'i am writing my first novel and hope to finish before the end of the year.']
Morning sickness: ['i have thrown up every day for the last 3 months with morning sickness.']
Tailgate party: ['i like tailgate parties.']
Ohio: ['i live on a small farm in ohio.']
Rachel Levin: ['i make videos about makeup.']
Alaska: ['i have been to every state except alaska.']
Fly fishing: ['i like to go fishing.']
Chevrolet Corvette: ['i own a corvette.', 'i need a corvette to complete my life.', 'i wish to buy a corvette when i retire.']
Hair coloring: ['i dye my hair blonde.', 'i have purple hair.']
Veterinary medicine: ['my dream is to be a veterinarian.', 'i am a veterinarian.']
Denmark: ['my grandma is from denmark.']
Real estate: ['we own our home.']
Entomology: ['i collect bugs in jars.']
Grand Theft Auto (video game): ['i like to play video games.']
Chevrolet Silverado: ['i drive a lifted chevy truck.']
Yellow: ['yellow is my favorite color.', 'my favorite color is yellow.']
Acura: ['i drive an acura.', 'i drive an acara.']
Culinary arts: ['i am a classicly trained chef.']
Ecstatic dance: ['i like to work out at the gym to christian electronic dance music.']
Koi: ['i have a pond at home with a pet koi named spot.']
Magazine: ['i work for a magazine.']
Mashed potato: ['my favorite food is mashed potatoes.']
Big Five (publishers): ['i working in a publishing building.']
Taco: ['i like tacos.', 'i love tacos but hate spaghetti.', 'my husband is the ceo of taco bell.', 'my favorite food is tacos.']
Badminton: ['i like playing badminton.']
Car: ['i love cars.']
Appleton, Wisconsin: ['i live in rural wisconsin.']
People (magazine): ['i work for a magazine.']
Track and field: ['i used to be able to run really fast.', 'i run track.']
IPhone: ['i prefer iphone over samsung.', 'i have an iphone.', 'my favorite phone is as iphone.', 'i couldn t live without my cell phone.']
Stamp collecting: ['i collect stamps.']
Urban agriculture: ['sometimes i volunteer at an urban farm.']
Tokyo: ['i just moved to los angeles from tokyo.', 'our class is planning a trip to japan.']
Acrylic paint: ['i like to work with acrylics.']
The Simpsons: ['i like cartoons.']
Ducati Motor Holding S.p.A.: ['i ride a motorcycle , but its not a harley.']
Wilderness: ['i like to be outdoors.']
Cardigan (sweater): ['i wear cardigans because i hope it makes me look more cultured.']
Grasshopper: ['i want to find out what its like to eat grasshoppers.']
Underwater diving: ['i enjoy deep sea diving.']
U2: ['my favorite band is u2.']
Party: ['i am good at throwing parties.']
Pork: ['i m lazy and pork tastes good.']
People watching: ['i like to go to bars and people watch.']
Ale: ['i always have a beer after work.']
Pita: ['i love to eat pita bread with hummus.']
The New Yorker: ['i have been published in the new yorker magazine.']
Gadget: ['i love new gadgets.']
Cake: ['i enjoy mystery flavour cake.']
Georgia (U.S. state): ['i am a georgia resident.']
Law firm: ['i work for a large law firm.']
Educational technology: ['i am taking courses online.']
Bartolo Colón: ['my favorite mob player is barolo colon.', 'my favorite mlb player is bartolo colon.']
Chicken: ['i love chickens.']
Baseball: ['my favorite hobby is playing recreational baseball.', 'in my free time , i watch anime and baseball.', 'i am a huge fan of baseball.', 'i like to play baseball.']
Irish coffee: ['i enjoy putting alcohol in my coffee.']
Cancer: ['my mom is a cancer survivor.']
Xbox: ['i like to play video games.', 'i like playing video games.', 'my favorite video game is halo 3.']
Madrid: ['i would also like to study abroad in spain.']
Culture of Chicago: ['i grew up in the projects of chicago.']
Ghost hunting: ['i am fascinated with ghosts.']
Autonomous car: ['i started working at google last week on self driving car research.']
Women's studies: ['i think i am failing my women studies class.']
Ovo vegetarianism: ['i m an ovo vegetarian.', 'i am an ovo vegetarian.']
A Song of Ice and Fire: ['i love game of thrones.', 'i also enjoy reading the game of thrones series books.']
New York Yankees: ['in my free time , i watch anime and baseball.']
Vermont: ['i live in vermont.']
Orthodontics: ['i hate that my mom made me get braces.', 'i have braces.']
Houseboat: ['i live on a boat.']
Grilling: ['i love to cook.']
General Electric: ['my father worked for ge.']
Seafood: ['i can t eat shrimp.']
Nightwish: ['my favorite band is nightwish.']
Allergic response: ['i am allergic to bees.']
Pediatrics: ['i am a doctor.']
Honda: ['i drive a honda that s seen better days.', 'i drive a honda car.']
Gummi candy: ['i can t get enough gummy worms to satisfy my sweet tooth.']
Sunfish: ['i usually catch sunfish.']
The Chainsmokers: ['i love the chainsmokers.']
Barbie Girl: ['my favorite song is barbie girl.']
Chevrolet: ['i have a brand new chevrolet.', 'my newest car is a chevy.']
Scooter (motorcycle): ['i like to ride my scooter.']
Nursing home care: ['i spend my free time volunteering at nursing homes.']
Yōkai: ['i am fascinated with ghosts.']
Shopping: ['i do the shopping in my house.']
Wrestling: ['i was a wrestler in high school.']
Automotive industry: ['my dad works in the automotive industry.']
Country: ['i love country.']
Cartoonist: ['and also love drawing.']
Bee: ['i am allergic to bees.']
Grunge: ['my sister and i are in a grunge band.']
Cake decorating: ['i like to make cakes.', 'i decorate cakes for a living.']
Flower: ['i work in a flower shop.']
Syracuse: ['i grew up in syracuse , ny with my parents and brother.']
Art museum: ['i like visiting art museums in my spare time.']
Christmas: ['christmas is my favorite holiday.', 'i love christmas.']
Collie: ['my dog is a collie.']
Eva Gutowski: ['i make videos about makeup.']
Overview of gun laws by nation: ['i have a gun collection at home.']
Reading (process): ['i love to read.', 'i like to read.', 'i read tons of books.']
Wedding cake: ['i run a small bakery.', 'i like to make cakes.', 'wedding cakes are my specialty.']
Equestrianism: ['i enjoy horseback riding.', 'i like horseback riding.', 'i have a horse named beauty.', 'i ride horses in my spare time.', 'i like to ride horses.']
Miss USA: ['i married miss usa.']
Metal Gear Solid: ['i like to play video games.']
Corn snake: ['i own two snakes.']
Silicon Valley (TV series): ['my favorite tv show is silicon valley.']
John Muir Trail: ['i love to go hiking.']
American Idol: ['i am an aspiring singer.']
Proxemics: ['i don t like when people get too close to me.']
Tex-Mex: ['my favorite food is spicy tex mex.']
California Love: ['my favorite song is california love.']
Chicago: ['i grew up in the projects of chicago.']
Roller coaster: ['i love riding roller coasters.']
Science, technology, engineering, and mathematics: ['i am very good at math and science.']
Medical school: ['i hope it to become a doctor one day.']
Cheesecake: ['i really like cake and don t prefer vegetables.', 'my favorite dessert is cheesecake.', 'i love cheese cake.']
Visual arts education: ['i work at a school as an art teacher.']
Kid Rock: ['my favorite singer is kid rock.']
Iguana: ['i have a pet iguana.', 'i have a few pet iguanas.']
Watercolor painting: ['i paint with watercolors.']
Law school in the United States: ['i m pursuing my law degree.']
Cut of beef: ['i like to eat beef.']
Game of Thrones: ['i love game of thrones.', 'i love watching game of thrones.', 'i m really excited to see how game of thrones ends.', 'my favorite show ever is game of thrones.']
Rose: ['my favorite flower is a rose.']
Mountaineering: ['i love adventures like mountain climbing.']
Desert: ['i love the desert.', 'my dream is to move to the middle of the desert.']
Yellowstone National Park: ['i love being in nature.']
Saudi Arabia: ['my mother is an immigrant from saudi arabia.']
Eye contact: ['i struggle with maintaining eye contact.']
Superhero: ['i used to wear a cape.', 'we liked to pretend we were superheroes.']
Science fiction: ['i enjoy movies about aliens invading the earth.', 'the future scares me.', 'i read sci fi space adventures with a passion.']
Soldier: ['my husband was a career soldier.']
Hop Along: ['my favorite band is hop along.']
Tom and Jerry: ['my favorite show is tom and jerry.']
The Technomancer: ['i play a lot of video games.']
Pizza: ['my favorite food is pizza.', 'i can t stand pizza.', 'i love pizza.', 'i cannot stand pizza.', 'i work at the pizza parlor.', 'i love to eat sushi and pizza.', 'pizza is my favorite.', 'i own a cat.']
Johann Sebastian Bach: ['i enjoy classical music.']
Shift work: ['i work nights now and like my job.']
The Strokes: ['i like early 2000s indie music.']
American Eagle Outfitters: ['my favorite store is american eagle.']
Virginia: ['we lived in virginia while i was growing up.']
Scuba diving: ['my wife and i like to go scuba diving.']
The Voice (U.S. TV series): ['my favorite show is thevoice.']
List of Walt Disney Pictures films: ['my favorite movies are disney movies.']
Partnership: ['i work for a large law firm.']
Donald Trump: ['i enjoying keeping up with the news and learning about political issues.']
American Society for the Prevention of Cruelty to Animals: ['i visit animal shelters fairly often.', 'i volunteer at animal shelters.']
Maine Coon: ['i have a cat.', 'i breed maine coon cats and show them.']
Yorkshire Terrier: ['i have 3 small dogs.']
Organizing (structure): ['people notice how organized i am.']
Holstein Friesian cattle: ['my family owns a dairy farm.']
Twin: ['i have a set of identical twin brothers.', 'my husband is an author and we have twins together.']
Rush (band): ['my favourite band is rush.']
Butcher: ['my father used to be a butcher.']
Pattern hair loss: ['i have male pattern baldness.', 'i am going bald.']
Olympic weightlifting: ['i am very athletic.']
Russia: ['my mother is from russia.']
Shark: ['i love sharks.']
Toga party: ['i like to party.']
Imagine Dragons: ['my favorite band is imagine dragons.', 'i like imagine dragons.']
Brie: ['my favorite food is cheese.']
Insane Clown Posse: ['my favorite band is insane clown posse.']
Pretty Woman: ['my favorite movie is pretty woman.']
Church music: ['i love to listen to religious music.']
Banana: ['i likw to go to the farmers markets to buy local veggies and fruits.']
Fruit picking: ['i like fruit.']
Black hair: ['my hair is black.']
Manta ray: ['i once swam with manta rays.']
Seattle: ['my favorite city is seattle.', 'my favorite place to visit is seattle.']
Giant panda: ['i love pandas.', 'my favorite animal is the panda.']
Phonograph record: ['i prefer vinyl records to any other music recording format.']
Tax: ['i believe the rich should not be taxed as much.']
The Pretenders: ['i love music of the 1980s , especially the pretenders.']
Laziness: ['i wish i didn t have to work.']
C++: ['i work remotely as a programmer.']
Beach: ['i love the beach.', 'i ve never been to the beach.', 'i like going to the beach.', 'my favorite place to spend time at is the beach.']
Obsessive–compulsive disorder: ['i was diagnosed with mild ocd in college.', 'ocd rules my life , and i have a hard time relinquishing control.']
Rockfish: ['my favorite is rock fish.']
Distance education: ['i am taking online classes.']
Lark (person): ['i am a morning person.']
California Pizza Kitchen: ['i work at the pizza parlor.']
Wage slavery: ['i have 10 years experience in our industry , yet she gets promoted.']
Factory: ['i work in a factory.']
Mental disorder: ['i have trouble feeling emotion.', 'i am bipolar.']
Skateboarding: ['skateboarding is a hobby of mine.', 'i like to skateboard.', 'i ride a skateboard.', 'i like skateboarding.']
History of libraries: ['i like the library.']
Techno: ['i listen to techno music , exclusively.']
Fender Musical Instruments Corporation: ['i am a guitar player.']
Upholstery: ['i own a custom upholstery shop.']
Dune (novel): ['i read sci fi space adventures with a passion.']
Southwest Airlines: ['i m a pilot for southwest.']
Security guard: ['i just finished training as a security guard.']
Genghis Khan: ['my college courses are on philosophy and history.']
Southern Baptist Convention: ['i sing in the church choir.']
Wheelchair: ['i am stuck in a wheel chair.']
Goldendoodle: ['i love dogs.']
Shellfish: ['i am allergic to shellfish and cats.', 'i love to eat shrimp and lobster.']
Kayaking: ['i like to kayak.', 'i kayak at the lake on weekends.']
Parsons School of Design: ['i went to school for fashion design and did nothing with it.']
Chocolate: ['i love chocolate.', 'chocolate is my favorite food.']
SpongeBob SquarePants: ['i watch a lot of spongebob.']
Genetically modified organism: ['i love non gmo foods.']
One Direction: ['my favorite band is one direction.']
Cartography: ['i am a cartographer.']
Graduate school: ['i am in my last year of grad school.']
Twilight (novel series): ['twilight is my favorite book series.']
Physical disability: ['i need a wheel chair to get around.', 'i am disabled and cannot walk.']
Acrophobia: ['my biggest fear in life is heights.']
Garfield: ['i love lasagna like i m garfield.']
Candy: ['i have never had candy in my life.']
A Tale for the Time Being: ['i also enjoy reading novels by female authors and exploring new areas.']
Sherlock Holmes: ['i like reading mystery novels.']
Rock climbing: ['i like rock climbing.']
Detroit Red Wings: ['my favorite sport is hockey.']
American Civil War reenactment: ['i am a civil war reenactment participant.']
Slasher film: ['i enjoy watching horror flicks.']
Country music: ['i enjoy listening to country music.', 'i love country music.', 'i like country music.', 'my least favorite music is country.', 'country music makes me cringe.', 'my favorite music is country.']
Harry Potter: ['i like reading.', 'i love to read harry potter books.']
Boston Celtics: ['i like basketball.', 'i am an avid fan of the boston celtics.']
Dr Pepper: ['i like dr pepper and black jack gum , but not together.', 'my favorite drink is dr pepper.']
Cabernet Sauvignon: ['my favorite drink is red wine.']
Professor: ['my mother is a teacher.']
Bulldog: ['i have two dogs , one pitbull and old english bulldog.']
Chicken nugget: ['i like chicken nuggets.']
Iron Maiden: ['my favorite band is iron maiden.']
Apple Inc.: ['i own an iphone.']
Programmer: ['i am a retired computer programmer.']
Fair: ['i sell miscellaneous stuff in local fairs.']
Dieting: ['i am on a diet.']
Zebra: ['zebras are my favorite animals.', 'my favorite animal is a zebra.']
Bisexuality: ['i am bisexual.']
Baileys Irish Cream: ['i enjoy putting alcohol in my coffee.']
7: ['my favorite number is 7.']
Lollipop: ['i cannot choose between lollipops and rainbows.']
Human height: ['i have a family that are all tall.']
Van Halen: ['i love the band van halen.']
Steak: ['my favorite food is steak.', 'i am a meataholic.', 'my favorite food is steak cooked well done.']
Allstate: ['i work at an insurance firm.']
Jane Austen: ['my favorite book is jane austins pride and prejudice.', 'my favorite book is jane austen s pride and prejudice.', 'my favorite author is jane austen.']
Neurosurgery: ['i am a doctor.']
Ragini (actress): ['i have a lizard named ragini.']
Whisky: ['i love to drink whiskey.']
Barbados: ['i am traveling to barbados next month.']
Guns N' Roses: ['my favorite artist is guns and roses.']
Nirvana (band): ['my sister and i are in a grunge band.']
Page boy (wedding attendant): ['my dog is the ring bearer.']
Dog: ['i have 3 small dogs.', 'dogs are my favorite animal.', 'i love dogs.', 'i have two dogs.', 'i want a dog , but that is a lot of commitment.', 'i have a dog.', 'i love kids and dogs.']
Social anxiety disorder: ['i currently suffer from social anxiety.']
Epilepsy: ['i have epilepsy.']
Hayao Miyazaki: ['in my free time , i watch anime and baseball.', 'someday i with to become a famous animator and work for a big company like dreamworks.']
Auto mechanic: ['my car broke down last week.', 'i work on cars for a living.']
Surgeon: ['i want to be a doctor when i graduate.']
Hitchhiking: ['i enjoy hitchhiking.']
Detroit: ['i m a police officer in a suburb of detroit.']
Discovery Channel: ['i work for the discovery channel creating videos.']
Insurance broker: ['my father used to be an insurance salesman.']
Ferret: ['i will one day own a ferret.']
Electronic music: ['i enjoy electronic music.', 'i am a student living at home while pursuing my music industry degree.']
Vietnamese Pot-bellied: ['i have always wanted a pot bellied pig.']
History of paper: ['i sell paper products for a living.']
Hearse: ['i own a hearse.']
Starbucks: ['i work at a coffee shop.']
Juicing: ['i am starting a new juicing bar.']
Narcissus (plant): ['i like to plant flowers in my gardens.']
Colorado: ['my name is mary and i m from colorado.', 'my name is mary and i am from colorado.']
Extreme Couponing: ['i am a couponed.', 'i am a couponer.']
Organic food: ['i only eat organic food.']
Golden Retriever: ['i have a pet dog.', 'i have a golden retriever.', 'we have 4 children and 2 dogs.', 'i have a golden retriever puppy.', 'i have 2 dogs , both golden retrievers.']
New Hampshire: ['i grew up in new hampshire.']
Columbia Pictures: ['my brother in law runs a major hollywood studio.']
Talent show: ['anyways i decided to give it a try and participated in an audition for a talent show.']
Chevrolet Tahoe: ['i own a chevy tahoe.']
Truck: ['i drive a truck for a living.']
Cinematography: ['i am obsessed with filming.']
Golden Gate Bridge: ['i am from san fransico.']
Common cold: ['i have found the cure for the common cold.']
Elvis Presley: ['i like to listen to elvis.', 'my mother met elvis.']
Soup kitchen: ['sometimes i volunteer at the soup kitchen.', 'i volunteer in my spare time.']
Mercedes-Benz S-Class: ['i drive a mercedes.']
Pittsburgh: ['i live in pittsburgh.']
Lawn game: ['i am a professional skittles player.']
Vietnamese cuisine: ['i cook well.']
Bitcoin: ['i am currently working on a project that involves bitcoins.']
Linebacker: ['my position is linebacker.']
Purple: ['my favorite color is purple.']
Cross country running: ['my days are filled with cross country try outs and basketball practice.']
Internet access: ['i have high speed internet.']
Frick Collection: ['i want to be a museum curator.']
Cruise ship: ['i am going on a cruise next month.', 'i have never been on a cruise ship.']
Road trip#Notable road trips in culture: ['driving in the country side is a pastime.']
Solar eclipse: ['i saw a solar eclipse when i was 8 years old.']
Hair: ['i have very curly hair.']
Sweden: ['i recently moved to sweden.']
Omar (name): ['my name is omar.']
Human cannibalism: ['i am a closet cannibal.']
Toyota Prius: ['i drive a prius.']
Choreography: ['i love to dance.']
San Diego Comic-Con: ['i go to multiple comic cons.', 'i like to go to comic con.']
Drawing: ['drawing in traditional style is my pasion.', 'i can draw.', 'i like to draw.']
String instrument: ['i am a violinist.']
Birdwatching: ['my weekends are filled with bird watching.']
Fertility factor (demography): ['i grew up with 6 siblings.']
Goodfellas: ['my favorite movie is goodfellas.']
Arsenal F.C.: ['i like to play soccer.']
Santa Fe, New Mexico: ['i now live in new mexico.']
Gibson Les Paul: ['i am a guitar player.']
Nike, Inc.: ['nike cleats are my favorite.']
Horror film: ['i enjoy watching horror flicks.']
Ozark Trail (hiking trail): ['we plan to travel after he retires.']
Boiled egg: ['i like to eat hard boiled eggs.']
Dream Theater: ['my favorite band is dream theater.']
Lactose intolerance: ['i am allergic to milk.', 'i am allergic to lactose.']
Farmer: ['i am a farmer.']
Wealth: ['i have more money than i know what to do with.']
Whole food: ['i only eat organic food.']
Sleeve tattoo: ['i have two full sleeves of tattoos.']
French Bulldog: ['i own a french bulldog.', 'i have a french bulldog.']
Bowling: ['i have bowled a 300 game twice in my life.', 'i am a professional bowler.', 'i like to bowl.']
Typing#Words per minute: ['i can type 140 words per minute.']
Rita Hayworth: ['rita hayworth is the woman of my dreams.']
Kayak: ['i enjoys kayaking in my free time.']
Carolines on Broadway: ['i love going to comedy clubs.']
Tomato: ['i hate tomatoes.']
Metropolitan Museum of Art: ['i enjoy going to museums.']
Hindu: ['i am a hindu living in louisiana.']
Temporomandibular joint: ['i have problems chewing my food.']
Stifel: ['my dad works for stifel.']
Amazon Echo: ['i love new gadgets.']
Grand Slam (tennis): ['i enjoy playing tennis.']
Maid: ['i am bored of my maids.']
Baltimore: ['i m currently looking for a job in baltimore.']
Philosophy: ['my college courses are on philosophy and history.', 'i study philosophy at mass.']
Flash (Barry Allen): ['my favorite hero is flash.']
American Red Cross: ['i volunteer at the red cross on the weekends.']
Auto racing: ['i have driven a race car before.', 'my favorite thing to do is research race cars in my free time.']
Fall Out Boy: ['i listen to a fall out boy record every day.']
Springfield, Missouri: ['i live in springfield , mo.']
Sport utility vehicle: ['i drive an suv.']
Alpaca: ['i have 10 alpacas.']
Cape Hatteras: ['i live in cape hatteras.']
Ender's Game: ['my favorite book is ender s game.', 'my favorite book is enders game.']
The Humane Society of the United States: ['i volunteer at the local humane society.']
Volcano: ['i like hiking up volcanoes.']
Wine tasting: ['i like to attend wine tours.']
Welsh Corgi: ['i have a dog and we go for walks.']
Ice hockey: ['i love hockey.', 'my favorite sport is hockey.']
Paramedic: ['i am a paramedic.']
Choir: ['my mother and father are both in the church choir.']
Bathroom singing: ['i sing in the shower.']
Battlestar Galactica (2004 TV series): ['my favorite show is battlestar galactica.']
Teacher: ['i used to be a chef , but i am a teacher now.', 'my mother is a teacher.', 'i am a school teacher.']
Detroit Tigers: ['i love the tigers baseball team.']
Cycling: ['i ride a bike.']
Pig farming: ['i live on a pig farm.']
Extra (acting): ['i work as an extra for major motion pictures.']
Contemporary slavery: ['i was a slave for 10 years.']
Betta: ['i have a beta fish.']
University of Massachusetts Amherst: ['i study philosophy at umass.']
Bodybuilding supplement: ['i drink protein powder with nothing but water.']
Music industry: ['i am a student living at home while pursuing my music industry degree.']
System of a Down: ['i am a fan of system of a down.']
Muse (band): ['my favorite band is muse.']
Video game design: ['i design video games for a living.']
Insect: ['i am deathly afraid of snakes , but not bugs.']
Skiing: ['i am a competitive ski racer.', 'i enjoy skiing.', 'i hate skiing.']
Linguine: ['my favorite food is italian.', 'i love pasta.']
Katie Perry: ['i listen to katie perry while in the shower.']
Shrimp: ['i can t eat shrimp.']
Jamaica: ['my favorite place to travel is jamaica.']
Dirty Harry: ['my favorite movie is dirty harry.']
University of Alabama: ['i am a geology major at alabama university.']
Beetroot: ['i can t stand beets.', 'i live on a beet farm.', 'i think beets are the best vegetable.']
Literacy: ['i never learned how to write.']
Carnivore: ['i used to be a meat eater but i am now a vegan.', 'i am primarily a meat eater.', 'i am a meat eater.']
Aldi: ['i work part time at aldi s.']
Rain: ['i love the sound of the rain.']
Blackjack: ['i am a blackjack dealer.']
Eye color#Brown: ['i have brown eyes.']
Catholic school: ['i go to a catholic high school in new england.']
Black Jack (gum): ['i like dr pepper and black jack gum , but not together.']
Anime: ['in my free time , i watch anime and baseball.', 'i love watching anime.', 'i like to watch japanese cartoons anime in my free time.', 'i like anime shows.']
YouTube: ['i love youtube.', 'i am a youtuber.']
Bachelor's degree: ['i graduated college in 2016.']
Public housing: ['i grew up in the projects of chicago.', 'i live in an apartment.']
Yo Gotti: ['my favorite rapper is yo gotti.']
Owner-occupancy: ['we own our home.']
Boxer (dog): ['i own two boxer dogs.', 'i have a boxer dog.']
Siamese cat: ['i have 3 cats.']
Apartment: ['i live in an apartment.']
New York University: ['i am a freshman at nyu.']
Police officer: ['my husband is a cop.', 'i work as a police officer.']
Shark attack: ['i love sharks.']
Broadway theatre: ['i enjoy broadway shows.', 'i like to sing broadway show tunes.']
Krav Maga: ['i m looking for krav maga classes near my home.', 'i am looking for krav maga classes near my home.']
League of Legends: ['i love to play league of legends.']
Haribo: ['i can t get enough gummy worms to satisfy my sweet tooth.']
Casino: ['i used to own a casino.', 'i used to own several casinos.']
Frank Ocean: ['i am touring with frank ocean.']
Romaine lettuce: ['i can t stand salads.']
Swimming stroke: ['i like to go swimming.']
Certified Public Accountant: ['i work at an accounting firm.']
Ford Mustang (first generation): ['i drive a restored mustang.']
Game show: ['i love to watch game shows.']
Big Four accounting firms: ['i work at an accounting firm.']
Chef: ['i used to be a chef , but i am a teacher now.']
Frank Sinatra: ['i love to listen to frank sinatra.']
North Dakota: ['i live in north dakota.']
Video game: ['i enjoy playing video games.', 'i like to play video games.', 'i like playing video games.', 'i am a girl who loves sports cars and video games.']
Courtship: ['i fell in love this summer.']
Circuit court: ['i m a judge in the circuit court.']
Taste: ['i hate the taste of cheese.']
Immanuel Kant: ['my college courses are on philosophy and history.']
Telecommunication: ['mom in telecommunications.']
Metallica: ['my favorite band is metallica.']
Stock market: ['i like to invest in the stock market.']
Dublin: ['i m 49 , male and live in dublin , ireland.', 'i am 49 , male and live in dublin , ireland.']
Army: ['i am in the army.', 'my husband is a soldier in the us army.']
Cartoon Network: ['i like cartoons.']
Beard: ['i have beard that is longer.', 'i have a big beard.']
Boredom: ['i am bored with my current lifestyle.']
Heavy metal music: ['i love rage metal music.', 'i like listening to all genres of music except country music.', 'my favorite type of music is metal.']
Sunset: ['i love sunsets.']
Barbershop music: ['i sing barbershop and rap.']
Doneness: ['my favorite food is steak cooked well done.']
Pizza delivery: ['i eat all take out.']
Beagle: ['my best friend is my dog allie.', 'i have a small beagle dog who i call droopy.']
Narcissism: ['i think i am fabulous.']
Asteraceae: ['my favorite flower is a daisy.']
Justin Timberlake: ['my favorite singer is justin timberlike.']
Daft Punk: ['i am a student living at home while pursuing my music industry degree.']
Hostage: ['i have been held hostage in a store robbery situation.']
Only child: ['i am an only child.']
Gone with the Wind (film): ['my favorite movie is gone with the wind.', 'i cry when i watch gone with the wind.']
Studio Ghibli: ['someday i with to become a famous animator and work for a big company like dreamworks.']
Baton Rouge, Louisiana: ['i was born in baton rouge.']
China: ['my father lives in china.']
Leprechaun: ['i believe in leprechauns.']
Hunting: ['i like to hunt.', 'i like to hunt for my food.']
Nachos: ['nachos are my favorite food.', 'nachos make me happy.']
HBO: ['i watch a lot of tv.']
Sprite (drink): ['i like sprite soda.']
Carrie Underwood: ['i like country music.']
Soft drink: ['i need a soda with me at all times.']
Beauty pageant: ['i use to compete in beauty pageants.', 'i won a beauty pageant one time but didn t feel like it was worth the effort.', 'i married miss usa.']
Juggling: ['i work in a circus as a juggler.']
Costume: ['i enjoy dressing up to go out clubbing.']
Toronto Raptors: ['my favorite team is the raptors.']
Trumpet: ['i play the trumpet.']
Blue Ridge Parkway: ['i like to take drives in the country.']
Kindergarten: ['i am a kindergarten teacher.', 'i teach kindergarten.']
Birth order: ['i m the oldest of three boys.']
Washington Wizards: ['i am a professional basketball player.']
Beastie Boys: ['my favorite band is the beastie boys.']
Kyoto: ['i am currently traveling in japan.', 'our class is planning a trip to japan.']
Alexander McQueen: ['my inspirations are alexander mcqueen and coco chanel.']
Fruitarianism: ['i am a fruitarian.']
Rugby football: ['i love sports , but rugby is my favorite.']
Mileena: ['my favorite mortal kombat character is mileena.', 'my favorite mortal combat character is milena.']
Video production: ['i am a youtuber.']
Nirvana: ['my sister and i are in a grunge band.']
Horse training: ['i train horses for a living.']
Marine aquarium: ['i blog about salt water aquarium ownership.']
Granny Smith: ['i like green apples.']
Beadwork: ['i enjoy doing beadwork and writing my own patterns.']
Smartphone: ['i have two smartphones.']
David Copperfield: ['my favorite book is david copperfield.']
Dylan's Candy Bar: ['i have a sweet tooth.']
Jaguar Cars: ['i drive a jag.']
Computer programming: ['my passion is in programming.']
Robert De Niro: ['my favorite actor is robert denaro.', 'my favorite actor is robert deniro.']
FC Barcelona: ['i enjoy playing soccer.']
Drake (musician): ['one of my favorite artists is drake.']
Madonna (entertainer): ['madonna is my all time favorite.']
Clown: ['i worked as a clown in the circus.', 'i m afraid of clowns.', 'i am afraid of clowns.', 'i am scared of clowns.']
Debt: ['i am in debt.']
Horror fiction: ['i like to read horror novels.']
Library: ['i like the library.']
Fishing tackle: ['i like fishing.']
Digital art: ['i am a digital artist.']
Oceania Cruises: ['i am going on a cruise next month.']
Gary Numan: ['sometimes i listen to gary human to be ironic.']
Lawyer: ['i am a lawyer.', 'i work as an attorney.', 'i work for a large law firm.', 'my husband is a lawyer.']
Saliva: ['i am studying to be a dental hygienist but i hate seeing patients saliva.']
Chicago-style pizza: ['i work at the pizza parlor.']
Netflix: ['i love to binge watch shows on streaming services.', 'i enjoy watching netflix with family.']
Piccadilly Circus: ['i want to move to london when i get older.']
Computer engineering: ['i enjoy building computers.']
Obesity in the United States: ['i feel overweight.']
Snoop Dogg: ['i love rap music.']
IndyCar: ['my favorite thing to do is research race cars in my free time.']
Scotch whisky: ['i collect single malt scotch.']
Time (magazine): ['i work for a magazine.']
Rafael Nadal: ['i like to play tennis.']
Grateful Dead: ['i used to follow the grateful dead when they toured.']
Editing: ['i work at home , editing.']
Animal print: ['i enjoy clothing with exotic prints.']
Google Pixel: ['i couldn t live without my cell phone.']
Border Collie: ['i want a dog , but that is a lot of commitment.', 'i have two border collies.']
Street dance: ['i love to dance.']
Tour de France: ['i love bicycling.', 'my hobbies include reading and cycling.']
University of Michigan: ['i am headed to university of michigan in the fall.']
Rural area: ['i live in a rural area.', 'we live in a rural area.']
Take-out: ['i eat all take out.']
Samsung Galaxy: ['i couldn t live without my cell phone.']
Beauty salon: ['i spend a lot of time on my hair and make up.', 'i have my own salon.']
Great Basin Desert: ['i love the desert.']
Komodo dragon: ['i like chasing comodo lizards on a private island.']
Chocolate chip cookie: ['i like cookies.']
Dobermann: ['i have a doberman.']
Buffalo Bills: ['i am a huge buffalo bills fan , and our family has season tickets.']
Communism: ['my father was a member of the communist party.']
French fries: ['i also eat too much french fries.', 'my life s passion is designer french fries.', 'my lifes passion is designer french fries.']
LGBT parenting: ['i was raised by two mothers.']
Bon Iver: ['my favorite band is bon over.']
Stepfamily: ['my parents are not married anymore.']
Dog training: ['i like to train dogs.']
Puzzle: ['i like to work puzzles.']
French kiss: ['i have never kissed a woman.']
Eye color#Blue: ['i have blue eyes.']
Anxiety disorder: ['i have a severe anxiety disorder.']
Dance squad: ['i am on a competitive dance team.']
Software engineering: ['i am in school to be a computer engineer.']
Japanese language: ['i started learning japanese at college.']
Karate: ['i know karate.', 'i have a black belt in karate.', 'i am a karate black belt.']
Horse: ['i hope one day to own a stable of at least 10 race horses.', 'i have a horse named beauty.', 'i have a farm with pigs , horses and hens.']
Sunrise: ['i wake early to watch the sun rise every day.']
Helianthus: ['i grow the tallest sunflowers you have ever seen.']
Stand-up comedy: ['i work as a stand up comedian.']
Kings of Leon: ['my favourite band is kings of leon.']
Tiny house movement: ['i live in a tiny house to save money.']
Bruno Mars: ['my favorite musician is bruno mars.', 'i love bruno mars.']
Snake: ['i m deathly afraid of snakes , but not bugs.', 'i have a pet snake.', 'i am deathly afraid of snakes , but not bugs.', 'i own two snakes.', 'i am terrified of spiders , but love snakes.']
Gap year: ['i am taking a year off before i start college.']
Beer: ['i always have a beer after work.', 'i am always the one who buys the beers.']
Glasses: ['i wear glasses.']
Extraversion and introversion: ['i hate talking to people.', 'i have lots of friends and can hold a conversation easily.', 'i enjoy talking to strangers.']
The Hitchhiker's Guide to the Galaxy: ['i read sci fi space adventures with a passion.']
Pickling: ['i like to pickle eggs.']
Ice cream: ['i cannot go a single day without eating ice cream.', 'my favourite food is ice cream.', 'i enjoy ice cream.', 'i eat ice cream when i am sad.', 'i can t go a single day without eating ice cream.']
Recycling: ['i think recycling is important.']
Vanilla: ['my favorite coffee is french vanilla.']
Italian language: ['my parents don t really speak english , but i speak italian and english.', 'my parents do not really speak english , but i speak italian and english.']
Minecraft: ['i enjoy playing video games.']
Chocolate brownie: ['brownies are my favorite dessert.']
Fashion design: ['i went to school for fashion design and did nothing with it.', 'my desire is to become a fashion designer.']
Mars: ['i want to go to mars.']
Depression (mood): ['i get sad a lot.', 'i wish i could speak another language.']
Immortality: ['i wish i could live forever.']
Santorini: ['i enjoy vacations at the beach.']
Las Vegas: ['i want to move to las vegas.']
Visual impairment: ['i am blind.', 'my son was born completely blind.']
Italian Americans: ['i am italian american.']
Iceland: ['i wish i could live in iceland.']
Porsche: ['i want a porsche.']
Sunday school: ['my mother was a sunday school teacher.']
Ireland: ['my mother was born in ireland.', 'i m 49 , male and live in dublin , ireland.', 'i ve always wanted to travel to ireland or puerto rico.']
Opera: ['i like to go to the opera.', 'i only listen to opera.']
The New York Times: ['i work for a newspaper.', 'my dad is journalist for the new york times.']
Searing: ['i love to cook.']
Dog biscuit: ['everyday after work i buy my dog a dog biscuit.']
Broccoli: ['i do not like broccoli.', 'i hate broccoli.', 'i don t like broccoli.']
Unemployment benefits: ['i am currently unemployed.']
StarCraft: ['i like to play video games.']
India: ['my father is from india.', 'i visit india often.']
Bird vocalization: ['i can do convincing bird calls.']
Publishing: ['i working in a publishing building.']
Pop music: ['my favorite music genre is pop.']
Romance (love): ['i have been in a lot of romantic relationships that have ended up poorly.']
List of art media: ['i like to draw and paint in my spare time.']
Pickled cucumber: ['i do not like pickles.']
Dolphin: ['my favorite animals are dolphins.']
Union College: ['i am currently studying at union college and want to be an english teacher.']
Puerto Rico: ['i am mixed with puerto rican and chinese.', 'i ve always wanted to travel to ireland or puerto rico.']
High school football: ['i played football in high school.', 'my son plays on the local football team.']
Commuting: ['i drive 300 mile a week for work.']
Barbie: ['i like playing outside in the sun with my dolls.', 'i like barbies.']
Trigonometry: ['my favorite subject in school is math.', 'i am a professional skittles player.']
Lasagne: ['my favorite food is italian.']
Show tune: ['i like to sing broadway show tunes.']
Ergonomic keyboard: ['i love ergonomic keyboards and chairs.']
Cannabis (drug): ['i like smoking weed.']
Cabana boy: ['i am lusting after the neighbour pool boy.']
Karaoke: ['i enjoy karaoke every friday night.', 'i love to sing.']
Yoga: ['i am a yoga instructor.', 'sometimes i go to yoga classes.']
Kale: ['i love eating kale.']
Blog: ['i started a small blog lately to post reviews.']
German Shepherd: ['i own four german shepherds.', 'i own a german shepard.']
Cosmetics: ['i like makeup.', 'i make videos about makeup.']
Debutante: ['i once lost a diamond at a debutante ball.']
Fairy tale: ['i believe in fairytales.']
Nevada: ['i grew up in nevada.']
Red Hot Chili Peppers: ['favorite band is red hot chilli peppers.', 'i love the band red hot chili peppers.']
Denver Broncos: ['my favorite sport is football.']
Nightclub: ['i enjoy dressing up to go out clubbing.', 'i am a night owl.']
Space Center Houston: ['i love living in texas.']
Radiohead: ['my favorite band is radiohead.', 'my favorite band is radiolead.']
Shaun White: ['i like to snowboard.']
Vampire: ['i once met a man i still believe was a vampire.']
Master of Business Administration: ['my major is business.', 'i go to school for business.', 'i graduated with a business degree , and marketing is all that i really enjoyed.']
American folk music: ['my favorite music is country.']
Jazz: ['i enjoy jazz music.', 'i play the trumpet.', 'i like jazz.']
Epileptic seizure: ['i have epilepsy.']
Motorcycle club: ['i am in a motorcycle club.']
Self-consciousness: ['i care about the way i look when i am in public.']
Louis Vuitton: ['i am fabulous from my on trend haircut to my louis vuitton.', 'i m fabulous from my on trend haircut to my louis vuittons.']
Crystal healing: ['i am really into the powers of crystals.']
Classical music: ['i listen to classical music.', 'i enjoy classical music.', 'i can play the piano.']
Carrot: ['my favorite food to harvest is carrots.']
Forgetting: ['i can be quite forgetful.']
Bakery: ['i run a small bakery.', 'when i retire i want to open a bakery.']
Federal judiciary of the United States: ['my next job will be in the federal court.']
Miley Cyrus: ['i live down the street from miley cyrus and pnb rock.']
Spaghetti with meatballs: ['my favorite food is spaghetti and meatballs.']
The Flintstones: ['i like the flintstones.']
Pipe smoking: ['i smoke a pipe.']
Orange juice: ['i also love orange juice.']
Interior design: ['i work as an interior designer.']
Finance: ['i work in finance.']
Live action role-playing game: ['i larp on the weekends in the forest.', 'i love to larp.']
Michael Phelps: ['i like swimming.']
The Avett Brothers: ['my favorite band is the avett brother.']
Western music (North America): ['my favorite music is country.']
John Lennon: ['i love the beatles.']
Johnny Cash: ['i enjoy listening to country music.']
Frédéric Chopin: ['i play the piano.']
Long-distance running: ['i can run very fast for long distances.']
TED (conference): ['i love to watch ted talks.']
Iced tea: ['i love iced tea.']
Mount Kilimanjaro: ['i love adventures like mountain climbing.']
Pink: ['pink is my favorite color.']
Lactose: ['i m allergic to lactose.']
Shrimp and prawn as food: ['i cannot eat shrimp.']
Kesha: ['ke ha is my favorite singer of all time.']
WWE: ['i secretly love watching wwe wrestling.']
Leather: ['i love the smell of leather.']
Quilting: ['i am an avid quilter.']
Animal rights: ['i spend time signing a lot of petitions and donate to animal rights groups.']
Gardening: ['i like to garden.']
Deep South: ['i grew up in the deep south.']
Milkshake: ['my guilty pleasure is mcdonald.', 'i love chocolate milk shakes.']
Christianity: ['i am a christian.', 'i am a true believer in god first.']
Taylor Swift: ['my favorite singer is taylor swift.']
Sushi: ['i also like eating sushi.', 'my favorite food is sushi.', 'i love to eat sushi and pizza.', 'i love sushi.', 'i m a vegetarian but i eat fish , especially sushi.']
Bipolar disorder: ['i am bipolar.']
The Cheesecake Factory: ['i love cheese cake.']
Volleyball: ['i coach the girls volley ball team.']
Gouda cheese: ['my favorite food is cheese.', 'i like the taste of cheese.']
Veganism: ['i am a vegan.', 'i m a vegan.', 'i used to be a meat eater but i am now a vegan.', 'i used to be a meat eater but i m now a vegan.']
The Hershey Company: ['i love chocolate.']
Sewing: ['i like to sew.', 'i like to sew my own clothing.']
Snare drum: ['i play the drums.']
Convertible: ['i only buy convertible cars.', 'i drive a yellow convertible in the rain.']
Small business: ['so i started a small business.']
Sobriety: ['i have never had alcohol.']
Lady Gaga: ['lady gaga is my current favorite singer.']
Marlboro (cigarette): ['i used to smoke.']
Black Rock Desert: ['my dream is to move to the middle of the desert.']
Comic book: ['i love comics.', 'i collect comic books.']
Dismissal of James Comey: ['i enjoying keeping up with the news and learning about political issues.']
Modernism: ['i love to paint.']
Bugs: ['i m deathly afraid of snakes , but not bugs.']
Tea: ['i drink 10 cups of tea every day.', 'i drink a lot of tea.']
Influencer marketing: ['i ve reached 50k subscribers !.', 'through them i ve learned to make up myself and others.']
Snorkeling: ['going snorkeling is my favorite thing to do.']
Marriage: ['i sometimes wonder why i m not married.', 'i am proposing tonight.']
Text messaging: ['i prefer texting over phone calls.']
Lamborghini: ['i am a girl who loves sports cars and video games.']
Pie: ['i am a great baker.']
Halo: Combat Evolved: ['i love the game halo.']
Nineteen Eighty-Four: ['1984 is my favorite book.']
Willie Nelson: ['my least favorite music is country.']
Red wine: ['my favorite drink is red wine.']
American football: ['i like football.', 'i played football in college.']
Volunteering: ['i volunteer with dogs.', 'i volunteer in my spare time.']
Catholic: ['i am catholic.']
Chevrolet Impala: ['i love my impala.']
Workplace relationships: ['i am dating my boss.']
University of California, Santa Cruz: ['i m on my way to uc santa cruz where i was accepted.', 'i am on my way to uc santa cruz where i was accepted.']
Australia: ['my father was born in australia.']
Del Taco: ['i am the leader of the french fry research department at del taco.']
Jimi Hendrix: ['my favorite music is jim hendrix.', 'my favorite music is jimi hendrix.']
Akira: ['i like to watch japanese cartoons anime in my free time.']
Yamaha Corporation: ['i drive a motorcycle instead of a car.']
Jess Greenberg: ['my favorite singer is jess greenberg.']
Halo 3: ['my favorite video game is halo 3.']
Hip hop music: ['i cannot get enough of rap music , its so good.', 'i can t get enough of rap music , it s so good.']
Who Wants to Be a Millionaire?: ['i love to watch game shows.']
Inner critic: ['i have a harsh inner critic.']
Osamu Tezuka: ['i love watching anime.']
Real property: ['i work as a legal assistant in a law firm that basically only handles real estate work.']
Ivy League: ['i went to an elite ivy league school.']
Homebrewing: ['i brew my own beer.']
Backstroke: ['i like swimming.']
Tesla, Inc.: ['i make cars for a living.']
Boston Terrier: ['my best friend is my dog allie.']
Night owl (person): ['i go to bed pretty late.', 'i am a night owl.', 'i prefer the night instead of the day.']
Ultimate Fighting Championship: ['i like watching ufc fights.']
Bathing: ['i like baths.']
Food allergy: ['i m allergic to shellfish.', 'i am allergic to shellfish.']
Elementary school: ['i teach 5th grade students near oakville , ny.', 'i teach elementary school children at a private school.']
Walking in the United Kingdom#Hillwalking: ['i like to go hiking.']
Bloating: ['i am bloated.']
Spider-Man: ['we liked to pretend we were superheroes.']
Baltimore Orioles: ['i play for the baltimore orioles.']
Alcohol: ['i enjoy the occasional drink with friends.']
Empire (2015 TV series): ['i am addicted to the hit show empire.']
Association football: ['i like to play soccer.', 'i enjoy playing soccer.', 'i am a soccer player.', 'i got a scholarship for playing soccer.', 'my favorite sport is soccer.']
Swimming: ['i don t know how to swim.', 'i like swimming.', 'i like to swim.', 'i like to go swimming.', 'i enjoy swimming.']
Paris: ['i got engaged to be married in paris , france.']
Humane society: ['i volunteer at the local humane society.']
Traffic collision: ['i have been in 2 car crashes in my life.', 'i lost my arm in a car accident.']
Chronic fatigue syndrome: ['i do not have much energy.']
Exploitation of labour: ['i pay my employees minimum wage.']
Leonardo da Vinci: ['i love to draw.']
Pride and Prejudice: ['my favorite book is jane austins pride and prejudice.', 'my favorite book is jane austen s pride and prejudice.', 'my favorite book is pride and prejudice.']
Newspaper: ['i work for a newspaper.']
Cheeseburger: ['my favorite food is a cheeseburger.']
Jason Mraz: ['i am a huge fan of jason mraz.', 'i m a huge fan of jason mraz.']
Eclipse: ['i watched the eclipse without using proper eye protection.']
Motorcycle: ['i drive a motorcycle instead of a car.']
Gambling: ['i sometimes spend too much money at the casino.']
IBM: ['i currently work for ibm in chicago.']
Widow: ['i am a widow.']
Welder: ['i am training to be a welder.']
Football: ['my favorite sport is football.']
Elementary school (United States): ['i just accepted a job at the elementary school in my hometown.']
Crossword: ['i enjoy crosswords , crocheting , and football.']
Wall Street: ['i work on wall street.']
Magic Mike: ['magic mike is my favorite movie.']
Two Steps from Hell: ['my favorite music is two steps from hell and rock opera genre.']
Grand Rapids, Michigan: ['i live near grand rapids , michigan.']
Ageing: ['i am an old woman.']
Gospel music: ['i love to listen to religious music.']
Toto (band): ['my favorite band used to be toto.']
Adam Levine: ['i m in love with adam levine.', 'i want to put my photos to a music video staring adam levin.']
History of Japan: ['my mom and dad are from japan.']
Creed (band): ['my favorite band is creed.']
Tardiness: ['i am always late.']
Kitten: ['i also like kittens.']
Opah: ['i usually catch sunfish.']
Nintendo: ['i enjoy playing video games.']
Mermaid: ['i believe that mermaids are real.']
Dallas: ['my name is john and i live in dallas , tx.']
Dungeons & Dragons: ['i play dungeons and dragons.', 'i play d and d.']
Star Trek: ['i really like watching star trek.']
Cartoon: ['i like cartoons.']
Intel 80386: ['i enjoy playing retro video games on my 386.']
DreamWorks: ['someday i with to become a famous animator and work for a big company like dreamworks.']
Monkey: ['my favorite animal is a monkey.']
Camping: ['my wife and two kids camp with me.']
Stephen Hawking: ['i have 3 science classes.']
Psychologist: ['i think i might need help.']
Disc jockey: ['i have a job as a dj at a radio station.']
Circus: ['i worked as a clown in the circus.']
Syracuse, New York: ['i grew up in syracuse , ny with my parents and brother.']
Meatloaf: ['i could eat meatloaf every night and never get tired of it.', 'my favorite food is meatloaf.']
Microsoft: ['my father used to work for microsoft.']
Leonardo DiCaprio: ['my favorite movie is titanic.']
Bob Ross: ['my favorite artist is bob ross.']
Wit: ['i am witty.']
Agatha Christie's Poirot: ['i love agatha christie novels.']
Singing: ['i am a talented singer and have won several competitions.', 'i love to sing.', 'i am an aspiring singer.']
Mushroom: ['my favorite food is mushroom ravioli.']
Adoption: ['i am adopted.', 'i was adopted.']
Dance improvisation: ['i like to dance.']
Confidence: ['i struggle with maintaining eye contact.']
Mobile phone: ['i couldn t live without my cell phone.']
List of orphans and foundlings: ['my parents are both dead.']
Instagram: ['i spend a good deal of time on social media.']
Navy: ['i work for the navy.', 'i am in the navy.']
Smoking: ['i used to smoke.']
Superman: ['superman s my favorite super hero.', 'my favorite hero is superman.']
Radiology: ['i am also a fulltime student studying radiology at local college.', 'i m also a fulltime student studying radiology at local college.']
The Joe Rogan Experience: ['i listen to podcasts.']
Emotional detachment: ['i have trouble feeling emotion.']
Polydactyly: ['i have 6 toes on one foot.']
Mystery film: ['i enjoy watching mystery movies.']
Bowie knife: ['my prized possession is a bowie knife.']
Butterfly: ['i love butterflies.']
Exercise: ['i exercise.', 'i work out to look good.', 'i love to workout.']
Pet: ['we have two pets as well.', 'i love dogs and cats.']
Cat: ['i have 2 cats.', 'i have a cat named felix and a small terror names emmy.', 'i have a cat.', 'i have four cats.', 'i had two cats growing up.', 'i have a cat named leela.', 'i am a cat person.']
Game design: ['i design video games for a living.']
Nickelback: ['my favorite band is nickelback.', 'i met my wife at a nickleback concert.']
Online game: ['i like playing games online.']
Origins of rock and roll: ['rock music is my favorite.']
Make-up artist: ['my mother is a professional make up artist.']
Record producer: ['i am interested in producing music.']
Coffee: ['coffee is important to me.', 'black coffee is my addiction.']
Genius: ['i am a genius and know over 300 languages.', 'i am a genius.']
Fear of the dark: ['i am afraid of the dark.']
Manicure: ['i love to have my nails done.']
Arnold Schwarzenegger: ['i like action movies.']
Mexico: ['i am from mexico.', 'i have traveled to europe and mexico.']
Portland, Maine: ['i live in portland , maine.']
Hospital: ['i am nurse.', 'i work at a hospital.']
Cat people and dog people: ['i am more of a cat person than a dog person.']
Cord-cutting: ['i do not own a television.']
The Tale of Genji: ['my favorite book is the tale of genii.']
Rock and roll: ['rock music is my favorite.', 'my favorite music is rock and roll.']
The Walking Dead (TV series): ['i like the tv show the walking dead.', 'i love the walking dead.']
Vegetarianism: ['i want to be a vegetarian.', 'i am a vegetarian.', 'i don t eat meat.', 'i m a vegetarian.']
Mathematics: ['my favorite subject in school is math.']
Alison Sudol: ['my favorite band is a fine frenzy.']
Washington Nationals: ['my favorite team is the washington nationals.']
Overeating: ['when i am stressed , i overeat.']
Hybrid vehicle: ['i drive a prius.']
Hair loss: ['i am bald.']
Amazon Kindle: ['i read ebooks more than hardcopies.']
Ketogenic diet: ['i am on a keto diet.', 'i am a meat eater.', 'i eat a lot of meat.']
Twelfth grade: ['i start my senior year of high school next week.']
Moped: ['i own a hot pink moped.', 'i drive a moped.']
Anne of Green Gables: ['my favorite book is anne of green gables.']
Bible: ['my favorite book is the bible.']
Homeschooling: ['i grew up homeschooled.']
Community theatre: ['i do community theater when i am not in school.']
Work–life balance: ['i work 60 hours a week.']
Louvre: ['i like visiting art museums in my spare time.']
Racquetball: ['i am a gym rat that loves to play racquetball.']
Saxophone: ['i m in a jazz band and play the saxophone.', 'i am in a jazz band and play the saxophone.']
Good Burger: ['my favorite movie is good burger.']
Thierry Henry: ['my idol is theirry henry.', 'my idol is thierry henry.']
Orson Scott Card: ['my favorite book is ender s game.']
Green: ['green is my favorite color.', 'my favourite colour is green.', 'my favorite color is green.']
Barista: ['during the week , i work as a barista.', 'i work as a barista.']
Water skiing: ['i like to water ski.']
Marathon: ['i like running in marathons.', 'i like to go running.', 'i am a marathon runner.']
People for the Ethical Treatment of Animals: ['i spend time signing a lot of petitions and donate to animal rights groups.', 'i work for peta.']
Middlesex (novel): ['my favorite book that i have read lately is middlesex.', 'my favorite book that i ve read lately is middlesex.']
Academic degree: ['i am going to school to get a degree now.']
100 metres: ['i used to be able to run really fast.']
Near-sightedness: ['i can only see 200 feet in front of me.']
Chalk: ['i hate the feeling of chalk.']
Family Guy: ['i like cartoons.']
Ultimate (sport): ['i like playing ultimate in the park with my guys sometimes.']
Mediterranean cuisine: ['i love to eat pita bread with hummus.']
Marching band: ['i am in the band.']
Parrot: ['i love my parrot , todd.', 'i have 3 dogs and a parrot.', 'i have a parrot named parrot.']
Korn: ['my favorite band is korn.']
George Foreman Grill: ['i have a george foreman grill at home.']
Somniloquy: ['i talk in my sleep.']
Guitar: ['i own 9 guitars.', 'my hobbies are sleeping and playing the guitar.', 'i play the guitar.', 'i am a guitar player.', 'i used to travel the usa playing guitar.']
Miranda Lambert: ['i love country.']
Taxicab: ['my father use to drive a taxi cab in the 1970 s.']
Rotisserie: ['i like to cook.', 'i love to cook.']
Homosexuality: ['my parents do not know i am gay.']
Softball: ['i love to play softball.']
Book review: ['i have none to share my thoughts about the books i read.']
Anatoly Karpov: ['my favorite hobby is chess.']
Pacific Crest Trail: ['i love to take my children on nature walks.']
Plantation: ['i grew up on a large farm.']
Weight training: ['i exercise everyday.', 'i like to go to the gym and work out.']
Full moon#Harvest and hunter's moons: ['i was born under a blood moon.']
Spice: ['i like spicy food.']
Apple: ['i am allergic to apples yet still eat them.', 'my favorite fruit is an apple.']
Amazon (company): ['i work at amazon.']
Salsa (dance): ['my favorite food is pizza.']
Archery: ['recently i started taking archery classes and love it.']
Body piercing: ['i have 10 piercings.', 'i have an eyebrown piercing.']
NASA: ['my boyfriend works for nasa.']
Running: ['i like to run.', 'running is my way to relax.']
Labrador Retriever: ['i love dogs , especially labradors.', 'i have two pet dogs.']
Volkswagen Passat: ['i drive a 2011 volkswagen passat.', 'i drive a 2011 volkswagen passa.']
Comedy: ['i love to tell jokes.']
Physical fitness: ['i have a very tone body.', 'i exercise.', 'i like to stay fit.', 'i love to workout.']
The Rolling Stones: ['my favorite band is the rolling stones.', 'i like the group the rolling stones.']
Hoarding: ['my mother has 500 pairs of shoes.']
Museum of Modern Art: ['i enjoy going to museums.']
Barnes & Noble: ['i work at a bookstore.']
Artist: ['i like to think about what it would be like to be an artist.']
Sneakers: ['i just bought a new pair of sneakers and they feel great.']
Spitz: ['i have a pomeranian.']
Muffin: ['i am a great baker.']
Kentucky: ['i grew up in kentucky.', 'i am going to start school at the university of kentucky.']
Molly Ringwald: ['my favorite movie is 16 candles.']
Rapping: ['i like rap music.']
Red: ['my favorite color is red.', 'i like the color red.']
German language: ['i speak fluent german.']
Gossip: ['i love to gossip.']
San Antonio Spurs: ['i like basketball.']
K-pop: ['kpop is my favorite music.']
BMW: ['i drive a bmw.']
Activism: ['i like to get involved in politics.', 'i often spend my free time engaging in activism work with friends and family.']
London: ['i just took a trip to london.', 'i am originally from london , england.', 'i want to move to london when i get older.']
Hawaii: ['i enjoy vacations at the beach.']
BBC: ['i like watching british tv shows and movies.']
Accounting: ['i work as an accountant.', 'i am an accountant.', 'i work at an accounting firm.']
Automobile repair shop: ['my husband owns a small auto repair shop.']
Poodle: ['dogs are my favorite animal.', 'i have two dogs.', 'i have a poodle named nanette.']
Mountain Dew: ['not a day goes by that i do not drink four mountain dews.', 'not a day goes by that i don t drink four mountain dews.', 'i need a soda with me at all times.']
Telenovela: ['now i am a fixture on a weekly telenovela.']
Stepfather: ['i had one step dad , and fortunately he ignored me.']
Minimum wage: ['until then i will make 215 an hour.']
Coors Brewing Company: ['my favorite beer is coors.']
Fibromyalgia: ['since i have fibromyalgia , the harsher winters here in pa will be rough on me.']
Camino de Santiago: ['i love to take my children on nature walks.']
South Park: ['my friend likes cartoons like south park.', 'i watch south park at least once a day.']
Milk allergy: ['i m allergic to milk.']
Lightning McQueen: ['i like lightning mcqueen.']
Overweight: ['i feel overweight.']
Back pain: ['my back hurts chronically.']
Agoraphobia: ['i have a severe phobia of wide open spaces.']
Paddleboarding: ['i paddle board on my days off.']
Social anxiety: ['my shyness made me panick and i did not show up.', 'i hate talking to people.']
Influenza: ['i am nurse.']
Italian cuisine: ['i enjoy cooking italian food.', 'my favorite food is italian.', 'i like italian cusine.', 'i like to cook.', 'i enjoy eating italian food.']
Young Frankenstein: ['i can recite the movie young frankenstein word for word.']
Special education: ['i am a special ed teacher.', 'i am studying to be a special education teacher.']
Sewing machine: ['my hobby is sewing.']
Pregnancy: ['i am pregnant with my first child.']
Weight loss: ['i have trouble losing weight.']
EuroBasket: ['i am hoping to play basketball overseas.']
PDF: ['i use third party programs to read portable documents instead of adobe.']
Austin, Texas: ['i m from austin , texas.', 'i love living in texas.', 'i am from austin , texas.']
Yachting: ['boating is my favorite activity.']
Regret: ['i wish i could take back a mistake.']
Blond: ['i have blonde hair.']
Healthy diet: ['i like cooking healthy meals.']
Preterm birth: ['i was born premature.']
Hamilton (musical): ['my favorite musical is hamilton.']
Obesity: ['i weight 300 pounds.', 'i am obese.']
Mexico City: ['i am from mexico.']
Lilium: ['my favorite flower is a lily.']
Chili pepper: ['i like spicy food.']
Caffeine: ['i do not consume caffeine.']
Computer repair technician: ['i am skilled in computer repair.']
Plant: ['i really love plants.']
Ben & Jerry's: ['my favourite food is ice cream.', 'i enjoy ice cream.']
Accent (sociolinguistics): ['i still have a thick accent so words like hippopotamus are difficult.']
Bagel: ['i like to make bagels.']
Sibling: ['i am one of four siblings.']
Slackware: ['playing quake on slackware linux makes me happy.']
Dragon Ball Zs: ['i like collectible dragon ball z figures.']
Medical billing: ['i have a lot of medical bills.']
Lucy Maud Montgomery: ['my favorite book is anne of green gables.']
Dental hygienist: ['i am studying to be a dental hygienist but i hate seeing patient s saliva.']
Piano: ['i play piano.', 'i play the piano.', 'i have taken formal music lessons since i was 5.']
Steam (software): ['i like playing games online.']
Tofu: ['i hate tofu.']
Ghost: ['i am fascinated with ghosts.']
Risk (game): ['i like to play board games.']
Dust: ['i am allergic to dust.']
Drum kit: ['i play drums in a band.', 'i play the drums.', 'a hobby of mine is the drums.']
Sports car: ['i am a girl who loves sports cars and video games.']
Field hockey: ['i like field hockey and soccer.']
Hachette (publisher): ['i working in a publishing building.']
Dog daycare: ['i want a dog , but that is a lot of commitment.']
Violin: ['i cannot get enough of lindsey spirlings music.', 'i play the violin.', 'i am a violinist.', 'i give lessons on string instruments.']
Stanford University: ['i went to stanford.']
Ferrari: ['i drive a ferrari.', 'i have 3 ferrari cars in my garage.', 'i am a girl who loves sports cars and video games.', 'ferrari is my favorite car company.']
Japan: ['i am currently traveling in japan.', 'i came from japan to teach high school over 10 years ago.', 'our class is planning a trip to japan.']
Channing Tatum: ['magic mike is my favorite movie.']
Thigh-high boots: ['my favorite outfit is thigh high leather boots and a skirt.']
Painting: ['i like to draw and paint in my spare time.', 'i love to paint.']
Yves Saint Laurent (brand): ['i still dream about going to paris and designing clothes.']
Whole Foods Market: ['i only eat organic food.']
The Story So Far (band): ['my favorite band is the story so far.']
Hummus: ['i love to eat pita bread with hummus.']
New England: ['i go to a catholic high school in new england.']
Indian cuisine: ['i love to cook ethnic foods.', 'i recently discovered a new love for indian food.']
Veterinary physician: ['i work as a veterinarian s assistant.', 'i would like to go to school to become a veterinarian.']
PlayStation: ['i like playing video games.']
Vegan: ['i eat a strictly vegan diet.']
NASCAR: ['watching nascar races is a great way to spend a sunday for me.', 'i race cars for a living.', 'my favorite thing to do is research race cars in my free time.']
Spider: ['spiders scare the life out of me.']
Walt Disney World: ['i travel every year to disney world.']
Target Corporation: ['i currently work at target.']
Picnic: ['my mommy makes me a picnic lunch to eat outside.']
Anxiety: ['i have depression and anxiety so i don t really go out a lot.']
National Basketball Association: ['i play basketball.']
Multilingualism: ['i am a genius and know over 300 languages.', 'i speak english and spanish fluently.']
Emily Dickinson: ['i like to write poetry.']
Golf: ['i enjoy golfing.']
React (JavaScript library): ['i like to create websites.']
Community colleges in the United States: ['i am a student at a small community college.']
Fiction: ['i am an aspiring fiction writer.']
Farmers' market: ['i like to go to the farmers markets to buy local veggies and fruits.', 'i like to go to the farmer s market every weekend.']
Dancing with the Stars: ['my favorite tv show is dancing with the stars.']
Brewery: ['i am a financial analyst for a brewery.']
Religion: ['i m very religious.', 'i pray to god for my family every morning.']
Unemployment: ['i am currently looking for employment.', 'i am looking for a job.', 'i am currently unemployed.', 'i am currently looking for a job.']
Rail transport: ['i work for the railroad.']
Physician: ['i want to be a doctor when i graduate.']
Ball python: ['i own two snakes.']
Brunch: ['i like to cook breakfast on sundays.', 'my favorite meal is brunch.']
Greece: ['my mother is from greece.', 'my family came from greece in the 1950s.']
United States Armed Forces: ['i am in the military.']
Palmistry: ['my mom is a palm reader in new orleans.']
Housewife: ['i am currently a stay at home mom while my husband is the sole provider.', 'my wife stays home with our kids.']
John Grisham: ['i enjoy john gresham movies , but not his books.']
Historical fiction: ['i am a writer.']
House dust mite: ['i am allergic to dust.']
Peyton Manning: ['i once saw peyton manning at the grocery store.']
Action film: ['i like watching action adventure movies and eating popcorn.']
Shower: ['i like to take cold showers.']
Airplane: ['i used to fly planes for a living.']
Pepsi: ['i like pepsi.']
Romeo and Juliet: ['i m a hopeless romantic.']
Chicago Loop: ['i own a bar in downtown chicago.']
Donna Karan: ['i favorite brand of clothing is donna karen.']
Fishing vessel: ['i own a boat.']
Diabetes mellitus: ['i am a diabetic.']
Sleep: ['i sleep 10 hours every day because my work is tiring.']
Tutor: ['i tutor kids in my spare time.']
Pecan pie: ['everyone says my pecan pie is the best they have ever had.']
Ravioli: ['my favorite food is mushroom ravioli.']
Coco Chanel: ['my inspirations are alexander mcqueen and coco chanel.', 'since young i ve loved fashion.']
Teapot: ['i love collecting teapots.']
Height: ['i am 6 foot tall.']
God: ['god has always been put first in my life.']
Ed Sheeran: ['my favorite musician is ed sheeran.']
Clearwater Beach: ['going to the beach is my favorite past time.']
Secondary education: ['i graduated college for secondary english education.']
Bentley: ['my favorite auto is a bentley.']
Jeopardy!: ['my favorite tv shows are forensic files and jeopardy.', 'i have appeared on the show jeopardy.']
Abdominal obesity#Colloquialisms: ['my beer gut is so huge i have not seen my feet in two years.']
Western philosophy: ['i study philosophy at mass.']
Knitting: ['i love to knit and crochet.']
It (2017 film): ['i m scared of clowns.']
Translation: ['i m a profesional translator.', 'i am a profesional translator.']
Unicorn: ['i still like unicorns even though i am an adult.', 'i still like unicorns even though i m an adult.']
Journalist: ['i am a retired newspaper reporter.']
Mechanic: ['i am a mechanic.']
Alcoholism: ['i am constantly drinking.', 'i am a recovering alcoholic.']
Psychiatrist: ['i see a therapist that doesn t really understand me.']
Tattoo: ['i have three tattoos.', 'i have a rose tattooed on my right ankle.', 'i have more then 10 tattoos.']
Major League Baseball: ['in my free time , i watch anime and baseball.']
United Parcel Service: ['my dad works for ups.']
Fisherman: ['i am a fisherman.']
South by Southwest: ['i m from austin , texas.']
Surfing: ['i surf everyday.', 'i like to surf.', 'i like to surf every chance i get.', 'i surf often.', 'i love to surf.']
My Little Pony: ['i like playing outside in the sun with my dolls.', 'my three ring binder has my drawings of ponies all over it.']
Education: ['i am dissatisfied with the school life i have had so far.']
Conductor (rail): ['i work for the railroad.']
Pasta: ['i enjoy cooking italian food.', 'my favorite food is pasta.', 'i love pasta.']
Avenged Sevenfold: ['my favorite band is avenged sevenfold.']
Conor McGregor: ['connor mcgreggor is my favorite fighter.', 'connor mcgregor is my favorite fighter.']
PnB Rock: ['i live down the street from miley cyrus and pnb rock.']
Cleat (shoe): ['nike cleats are my favorite.']
Whittling: ['i like canning and whittling.', 'whittling is my favorite hobby.']
Terrestrial locomotion: ['i like to run.']
Fiction writing: ['i m writing my first novel and hope to finish before the end of the year.']
Preschool: ['i teach kindergarten.']
Hollywood: ['i love going to the movies.', 'my brother in law runs a major hollywood studio.']
Electric violin: ['i play electric violin , and also work as an accountant.']
Pharmacist: ['i am a pharmacist.']
Janitor: ['my mom is a janitor.']
Role-playing: ['i like to role play.']
Retirement home: ['i live in a retirement home.']
Allergy: ['i have allergies.', 'i have horrible allergies.', 'i am allergic to dust.']
Winter: ['i prefer winter.', 'i prefer winter over fall.']
Allergy to cats: ['i have horrible allergies.']
Botulinum toxin: ['i think i need botox soon.']
Hiking: ['i like to go on long hikes.', 'i love the outdoors.', 'i like to go hiking.', 'i love to go hiking.', 'i like to hike.']
Clubbing (subculture): ['i enjoy dressing up to go out clubbing.']
Ocean: ['i love the beach.']
List of tourist attractions in Paris: ['i am traveling to paris this year for my vacation.']
Ex (relationship): ['i am still in love with my ex boyfriend.']
Halloween: ['halloween is my favorite holiday.', 'my favorite holiday is halloween because i like dressing up.']
Micropterus: ['i like to go fishing.']
Mike Trout: ['my favorite player is mike trout.']
Bank teller: ['now i also work at a bank.', 'i work in a bank.']
Avengers (comics): ['i love watching superheroes shows.']
Ballet: ['i love ballet.', 'i dance ballet.', 'my mother is a ballet dancer.']
The Tonight Show Starring Jimmy Fallon: ['i watch jimmy fallon s show every night.']
Animal shelter: ['i visit animal shelters fairly often.', 'i volunteer at animal shelters.', 'i volunteer with dogs.', 'i volunteer at an animal shelter.', 'i am gong to adopt a dog very soon.', 'i volunteer at my local animal shelter.']
Lifeguard: ['i work as a lifeguard.', 'i work as a lifeguard at a beach.']
Cappuccino: ['my favorite drink is caramel cappuccino.']
Orphan: ['i grew up as an orphan.', 'my brother raised me after our parents died.']
Rancid (band): ['my favorite band is the punk band rancid.']
Composer: ['i am a student living at home while pursuing my music industry degree.']
Sex Pistols: ['in the evenings i watch the door at a club where they play punkrock.']
Divorce: ['i am recently divorced.', 'i have 3 ex wives.', 'my husband just decided to leave me.', 'my parents were divorced.', 'my parents are not married anymore.', 'my parents are divorced.']
Broken heart: ['my heart hurts from a broken relationship.']
Compulsive hoarding: ['i am a couponed.']
1980s in music: ['i love 80 s music.']
Nurse practitioner: ['i go to work early in the morning as a nurse.']
Oaksville, New York: ['i teach 5th grade students near oakville , ny.']
Wisconsin: ['i live in rural wisconsin.']
Ween: ['my favorite band is ween.']
Linkin Park: ['i listen to linking park , i do not know why.', 'i listen to linkin park , i don t know why.']
Bone fracture: ['i recently broke my leg.']
Luxury yacht: ['i have more money than i know what to do with.']
Nashville, Tennessee: ['i live in nashville.']
Strawberry: ['my favorite food is strawberries.']
Pet adoption: ['i am gong to adopt a dog very soon.']
Technical drawing: ['i like to draw.']
List of water sports: ['i enjoys kayaking in my free time.']
Zumba: ['i love zumba.']
Kick scooter: ['i like to ride my scooter.']
New York City: ['i live in a big city.', 'my favorite city is new york.', 'i live in new york.', 'i live in new york city.', 'i live in a small apartment in new york.']
Mick Jagger: ['my favorite band is the rolling stones.']
Dragon: ['i wish i had a real dragon i could train.', 'i believe dragons are real.']
Music festival: ['i love going to concerts and dancing hard.']
Dating: ['i just started dating someone new.', 'i enjoy dating women.', 'i only date people taller than me.']
Gemini (astrology): ['my birthday is in june.']
Acoustic guitar: ['i play the guitar.']
Angling: ['i enjoy fishing.']
Welding: ['i am training to be a welder.', 'welding is my career field.']
Magic: The Gathering: ['i enjoy magic the gathering , it is a card game.']
Star Wars: ['my favorite movie is star wars.']
Blue: ['my favorite color is blue.']
Dance: ['i like to dance.', 'i love to dance.', 'dancing is my passion.']
National Guard of the United States: ['i am a national guard officer.']
Violin family: ['i am a violinist.']
Pudding: ['pudding makes me gassy.']
Avengers: Infinity War: ['i like watching action adventure movies and eating popcorn.']
Electrician: ['i work as an electrician.']
Rock music: ['my favorite music genre is rock.', 'rock music is my favorite.', 'i love rock music.']
Yoga as exercise: ['i do yoga three times a week.']
Peanut: ['in allergic to peanuts.']
Oriental Shorthair: ['i have a cat.']
Corn dog: ['i can never decide between a chili corn dog and a cheesy hot dog.']
Old age#Senior citizen: ['i am a senior citizen.']
Peanut allergy: ['i am allergic to peanuts.']
French cuisine: ['i like to cook.']
Star: ['i lay awake at night so i can watch the stars.']
Florida: ['my uncle use to work on fish boats in florida.', 'i prefer summer over winter.', 'my parents recently moved to florida.', 'i live in celebration , florida.', 'i recently moved to florida.']
Marduk (band): ['marduk is my favorite band.']
The Royal Ballet: ['my mother was a famous ballet dancer in london.']
Zoella: ['i make videos about makeup.']
Clarinet: ['my older sister plays clarinet.']
Physics: ['i have 3 science classes.']
Go-kart: ['i like to race go carts.']
Retirement: ['i am a retired school teacher.']
Shopping addiction: ['i have a shopping addiction.']
Budweiser: ['i enjoy budweiser beer.']
Nursing: ['i am nurse.', 'i worked as a nurse for many years.', 'i go to work early in the morning as a nurse.']
Hockey: ['i love hockey.', 'i used to play hockey.']
United Kingdom: ['i just took a trip to london.']
Gymnastics: ['i am a gymnast.']
Cross-country skiing (sport): ['i am a competitive ski racer.']
Cheerleading: ['i am a cheerleader.', 'i used to cheerlead in high school.']
Orc: ['there i m a general of an orcish army.', 'there i am a general of an oris army.']
Disability: ['i am stuck in a wheel chair.']
Niagara Falls: ['i spend the weekends travelling up to canada to relax and enjoy the view.', 'we will be traveling to niagra falls for our honeymoon.']
New York-style pizza: ['i love pizza.', 'pizza is my most favorite thing.', 'i work at the pizza parlor.']
Charity shop: ['sometimes i like to visit thrift shops.']
Registered nurse: ['i am a registered nurse.']
Woodstock: ['my parents met at woodstock.']
Adolescence: ['i am a fourteen year old living with my mom and grandparents.']
Internet Relay Chat: ['i talk a lot in irc.']
Lexus: ['i drive a silver lexus.']
Jaguar: ['i drive a jag.']
Computer science: ['i will study computer science.']
Batman: ['i used to wear a cape.', 'we liked to pretend we were superheroes.']
Denver Art Museum: ['i like visiting art museums in my spare time.']
Big Brother (franchise): ['i like watching reality television shows.']
Cue sports: ['i am excellent at playing pool.', 'i enjoy playing recreational games like cards , darts or billiards.']
Scripps National Spelling Bee: ['as a child , i won a national spelling bee.']
Band (rock and pop): ['i have been in band all four years of high school.']
Open relationship: ['i wish my boyfriend didn t want an open relationship.']
Detective fiction: ['i like reading mystery novels.']
Bifocals: ['i wear glasses.']
Near-death experience: ['i have survived near death experiences.']
Pit bull: ['i have two dogs.', 'i have two dogs , one pitbull and old english bulldog.', 'i have two pitt bulls.']
Aircraft pilot: ['i m a pilot for southwest.', 'i fly airplanes.', 'i want to learn how to fly an airplane.']
Spanish language: ['i can speak three languages english , french and spanish.']
Coach (sport)#American football: ['i got a job as a coach at a local highschool.']
Kendrick Lamar: ['i listen to rap.']
Iron supplement: ['i need extra iron in my diet.']
Lizard: ['i have a lizard named nagini.', 'i have a pet lizard named gila.', 'i like lizards.']
Consulting firm: ['i own my own small marketing consulting agency.']
Showtime Networks: ['i watch a lot of tv.']
Reality television: ['i am a reality tv star.']
Breakfast: ['i like to cook breakfast on sundays.']
Solitude: ['i want to be alone sometimes.']
Chicago metropolitan area: ['i live in chicago.']
Penn & Teller: ['penn teller are my favorite magicians.']
Goalkeeper (association football): ['i am a goalie.']
Developmental disorder: ['one child has autism.']
World Wide Web: ['i like the internet.']
History of vegetarianism: ['i am a vegan.']
Concert: ['i like spending time with friends playing sports and going to country concerts.']
Miami: ['i would like to move some place warmer.', 'my parents recently moved to florida.']
Overwatch (video game): ['i play a lot of video games.']
Ford Mustang: ['i drive a ford mustang.', 'i drive a restored mustang.', 'i have owned two mustangs.']
Mile run: ['i once ran the mile in under 4 minutes.']
Reddit: ['i post on reduit often.']
Husky: ['i have a dog.', 'i have two siberian huskies.', 'i have a pet husky.']
Tuesday: ['i do yoga on tuesdays.']
Cookie jar: ['i wish i was taller so i could reach the cookie jar.']
Disco: ['i enjoy dressing up to go out clubbing.']
Big Mac: ['i work at mcdonalds.']
Mental health: ['but , i feel lost and far away from who i truly am.']
Rainbow: ['i cannot choose between lollipops and rainbows.']
Macaroni and cheese: ['my favorite food is macaroni and cheese.', 'i love mac and cheese.']
Kurt Cobain: ['the death of kurt cobain marred my middle school years.']
Unicycle: ['i ride a unicycle.']
Photography: ['i m a photographer.', 'i am saving up to buy a new camera.', 'i love photography.', 'my hobbies include photography and hiking.', 'i like photography.', 'my passion is photography.']
Educational trail: ['i love to take my children on nature walks.']
Hippopotamus: ['if i were to be reincarnated , i would want to come back as a hippopotamus.', 'if i were to be reincarnated , i d want to come back as a hippopotamus.']
Electronic dance music: ['i enjoy electronic music.']
History of tattooing: ['i have three tattoos.']
Slacker: ['i have often been called a slacker.']
Real estate broker: ['i work at a real estate office.']
Dental braces: ['i hate that my mom made me get braces.', 'i have braces.']
Cleveland Cavaliers: ['i like basketball.']
Preacher: ['my father is a preacher.']
Hot dog: ['hotdogs are my favorite food.']
Asthma: ['i have asthma.']
Katy Perry: ['i listen to katie perry while in the shower.', 'i like katy perry as a musician.']
Potato: ['i like potatoes.']
Waiting staff: ['i make and me by waiting tables.', 'i wait tables.']
The Lord of the Rings: ['there i m a general of an orcish army.', 'i like reading.']
Cupcake: ['i like cupcakes.', 'i also own a cupcake business.']
Tourism in Italy: ['this summer i went on vacation to italy.']
Golf Channel: ['i enjoy watching tennis and golf on tv.']
Scooby-Doo: ['my favorite show is scobby doo.', 'my favorite show is scooby doo.']
Spaghetti alla puttanesca: ['i like italian cusine.', 'i like to eat spaghetti.']
Baking: ['i love to bake cakes.', 'i like to bake for them.', 'i like to make cakes.', 'i like to bake pies.']
Religious music: ['i love to listen to religious music.']
Musical instrument: ['i play music in my spare time.']
Extraterrestrial life: ['i believe in aliens.', 'i wonder about what life in space would be like.']
Family farm: ['i didn t go to college because i run the family farm.']
Mansion: ['i live in a large home.']
City council: ['i am active on my city council.']
DC Comics: ['i collect comic books.', 'i love comic books.']
Tennis: ['i enjoy watching tennis and golf on tv.', 'i like to play tennis.', 'i enjoy playing tennis.']
Pancake: ['my favorite breakfast is pancakes.']
Perfectionism (psychology): ['i have a harsh inner critic.', 'i m a perfectionist.']
Crunch Fitness: ['i exercise often and have nice muscles.']
Long hair: ['my hair is very long.']
Burrito: ['my favorite thing to eat is a burrito.', 'i like burritos.']
David Mach: ['my hobby creating houses out of matches.']
Clueless: ['cher from clueless is my idea of perfection.']
Us Weekly: ['i work for a magazine.']
Rock opera: ['my favorite music is two steps from hell and rock opera genre.']
Halo (series): ['i love the game halo.']
Grocery store: ['i work in a corner grocery store during the day.', 'i am currently trying to open my own grocery store.']
Hypochondriasis: ['my friends tell me that i m a neurotic hypochondriac.']
Butterfly stroke: ['i like to go swimming.']
Cat senses#Sight: ['i wear glasses that are cateyes.']
Journalism: ['i want to be a journalist but instead i sell washers at sears.']
Summer camp: ['i do not have too many friends in the us yet , but i am going to summer camp and i hope to make friends then ! i also think that i may make friends as soccer in the fall.']
Retirement community: ['i live in a retirement home.']
Mountain bike: ['i like to mountain bike.']
Pittsburgh Steelers: ['i am a steelers fan.']
CN Tower: ['i spend the weekends travelling up to canada to relax and enjoy the view.']
Trance music: ['i love most music except country and jazz.']
Animals in sport: ['i like horseback riding.']
Appletini: ['i drink a lot of apple martinis when i get a girls night out.']
Minnesota Timberwolves: ['i was drafted last years by the minnesota wolves.']
Lindsey Stirling: ['i can t get enough of lindsey stirling s music.']
My Little Pony: Friendship Is Magic fandom: ['i enjoy all things my little pony.']
J. K. Rowling: ['the only autographs i ve ever wanted are from authors.']
Inline skates: ['i like to skate.']
Fried chicken: ['my favorite foods are fried chicken and chocolate cake.']
New Age: ['i m really into the powers of crystals.']
Skunk: ['i have a pet skunk.', 'my purse has a picture of a skunk on it.']
Vancouver Grizzlies: ['my favorite basketball team is the vancouver grizzlies.']
Rum and Coke: ['my favorite drink is cuba libre.']
Freckle: ['i have freckles all over my face.']
National Hockey League: ['my favorite sport is hockey.', 'i used to play hockey.']
Chihuahua (dog): ['i grew up in nevada.']
Higher education in the United States: ['i am taking a year off before i start college.']
Bass drum: ['i play the drums.']
Museum: ['i work at a museum.']
Art: ['i like doing art projects.']
Athletics (physical culture): ['i love to run fast.']
Contact lens: ['i am near sighted and wear contact lenses.']
List of islands of Greece: ['my family came from greece in the 1950 s.']
The Last of the Mohicans (1992 film): ['my favorite movie is the last of the mohicans.']
New Mexico: ['i now live in new mexico.']
Autograph: ['i have an autograph collection with more than 2000 signatures.']
Candle: ['i like to use candles instead of lights.']
Basketball: ['i like basketball.', 'my days are filled with cross country try outs and basketball practice.', 'i am not very good at playing basketball.', 'i love basketball.']
List of YouTubers: ['i am a youtuber.']
Shortstop: ['i am going to be the starting shortstop.']
Depression: ['sometimes i wish i did not have to wake up in the morning.']
Halloween costume: ['my favorite holiday is halloween because i like dressing up.']
Android (operating system)#Applications: ['i like to make cellphone apps that would help heal our world.']
Green Eggs and Ham: ['i do not like green eggs and ham.']
Alabama: ['i live in alabama.', 'i grew up in alabama.']
